NO ./textures/brick.xpm
SO ./textures/shrader.xpm
WE ./textures/porsche.xpm
EA ./textures/shrek.xpm

F 115,72,40
C 166,151,139


        11111111111111111111111111
        10000000001100000000000011
        10110000011100000000000011
        10010000000000000000000011
1111111110110000011100000000000011
1000000000110000011101111111111111
111101111111110111000000100011
111101111111110111010100000011
110000001101010111000000100011
100000000000000011000000100011
100000000000000011010100100011
11000001110101011111011110S0111
11110111 1110101 1011110100011
11111111 1111111 1111111111111